# # # # . # # # # # # # # # #
# . . . . . . . . . . . . . #
# . # # # # # # # # . . . . #
# . # w0 . . . . . w1 . . . . #
# . # . . . . k4 . . . . . . #
# . . w3 . . . . . w2 . # . . #
# . . . . . # # # . . . . . #
# . . . . . # # # . . . . . #
# # # # # # # # # # # # # # #