# # # # # # # # # # # # # # #
# . . . . . . . . p . . . . #
# . . . . . . . . . . . . . #
. . . # . # . # # # . # . . #
# . . . # . . # s # . # . . #
# . . . # . . # . # . . . . #
# . . . # . . # # # . # . . #
# s . . . . . . . . . . . k1 #
# # # # # # # # # # # # # # #