# # # # # # # # # # # # # # #
# . . . . . . . . . . . . . #
# . . . . . . . . . . . . . #
. . . # . # . # # # . # . . #
# . . . # . . # . # . # . . #
# . . . # . . # . # . . . . #
# . . . # . . # # # . # . . #
# . . . . . . . . . . . . . #
# # # # # # # # # # # # # # #