# # # # # # # # # # # # # # #
# . . . . . . . . . . . . . #
# . # # # . . . . . . . . . #
# . # # # . . . . . . . . . #
# . # # # . . . . . . . . . #
# . . . . . . . . . . . . . #
# . . . . . . # . . . # # # #
# . . . . . . . . . . . . . #
# # # # []1 # # # # # # # # # #