# # # # # # # # . # # # # # #
. w1 . . . . . . . . . . . w0 #
# . # # # . . . . . . . . . #
# . . k1 # p . . . . . . . . []2
# . # # # . . . . . . . . . #
# . . . . . . . . . w4 . . w5 #
# . s . . . . # . . . # # # #
# w2 . . . . . . . . w3 . . k2 #
# # # # []1 # # # # # # # # # #