# # # # # # # # # # # # # # #
# . . . . . . . . . . . . w1 .
# . s . . . . . . . . . . . #
# . . . . . . . . . . . . . #
# # # # # . . . . . . . . . #
# . . . # . . . . . . . . . #
# . k3 . # . . . . . . . . . #
# . . . . . . . . . . . . w0 #
# # # # # # # # # # # # # # #