# # # # # # # # . # # # # # #
. . . . . . . . . . . . . . #
# . # # # . . . . . . . . . #
# . # # # . . . . . . . . . []2
# . # # # . . . . . . . . . #
# . . . . . . . . . . . . . #
# . . . . . . # . . . # # # #
# . . . . . . . . . . . . . #
# # # # []1 # # # # # # # # # #