# # # # # # # # # # # # # # #
# . . . # . . . . . . . . . #
# . c . # . . . . . . . . . #
# . . . # . . . . . . . . . #
# . . . # . . . . . . . . . #
# . . . # . . . . . . . . . #
# . . . # . . . . . . . . . #
# . . . []3 . . . . . . . . . #
# # # # # # # # . # # # # # #