# # # # # # # # . # # # # # #
. w2 . . . . . . . . . . . w1 #
# . # # # . . . . . . . . . #
# . . k1 # . . . . . . . . . []2
# . # # # . . . . . . . . . #
# . . . . . . . . . w5 . . w6 #
# . s . . . . # . . . # # # #
# w3 . . . . . . . . w4 . . k2 #
# # # # []1 # # # # # # # # # #