# # # # . # # # # # # # # # #
# . . . . . . . . . . . . . #
# . # # # # # # # # . . . . #
# . # w0 . . . . . w1 . . . . #
# . # . . . . k3 . . . . . . #
# . . w3 . . . . . w2 . # . . #
# . . . . . # # # . . . . . #
# . . . . . # # # . . . . . #
# # # # # # # # # # # # # # #