# # # # . # # # # # # # # # #
# . . . . . . . . . . . . . #
# . # # # # # # # # . . . . #
# . # . . . . . . . . . . . #
# . # . . . . . . . . . . . #
# . . . . . . . . . . # . . #
# . . . . . # # # . . . . . #
# . . . . . # # # . . . . . #
# # # # # # # # # # # # # # #