# # # # # # # # # # # # # # #
# . . . . . . . . . . . . . .
# . . . . . . . . . . . . . #
# . . # . # . # # # . # . . #
# . . . # . . # . # . # . . #
# . . . # . . # . # . . . . #
# . . . # . . # # # . # . . #
# . . . . . . . . . . . . . #
# # # # # # . # # # # # # # #